         The Maze
  |----|----|----|----|----|
  |
3 |                      D
  |----|----|    |----|----|
  |                        |
2 |                        |
  |    |----|----|----|----|
  |                        |
1 |                        |
  |----|----|----|    |----|
  |                        |
0 | S                      |
  |----|----|----|----|----|
     0    1    2    3   4

  ---> East

  |S = Start Location
  |D = Destination
